1_1,1_2,1_3,2_1,2_2,2_3,3_1,3_2,3_3,4_1,4_2,4_3
1,1,0,1,0,0,0,0,0,0,0,0
1,1,1,0,1,0,0,0,0,0,0,0
0,1,1,0,0,1,0,0,0,0,0,0
1,0,0,1,1,0,1,0,0,0,0,0
0,1,0,1,1,1,0,1,0,0,0,0
0,0,1,0,1,1,0,0,1,0,0,0
0,0,0,1,0,0,1,1,0,1,0,0
0,0,0,0,1,0,1,1,1,0,1,0
0,0,0,0,0,1,0,1,1,1,0,0
0,0,0,0,0,0,1,0,0,1,1,0
0,0,0,0,0,0,0,1,0,1,1,1
0,0,0,0,0,0,0,0,1,0,1,1
