1_1,1_2,1_3,1_4,2_1,2_2,2_3,2_4,3_1,3_2,3_3,3_4,4_1,4_2,4_3,4_4
1,1,0,0,1,0,0,0,0,0,0,0,0,0,0,0
1,1,1,0,0,1,0,0,0,0,0,0,0,0,0,0
0,1,1,1,0,0,1,0,0,0,0,0,0,0,0,0
0,0,1,1,0,0,0,1,0,0,0,0,0,0,0,0
1,0,0,0,1,1,0,0,1,0,0,0,0,0,0,0
0,1,0,0,1,1,1,0,0,1,0,0,0,0,0,0
0,0,1,0,0,1,1,1,0,0,1,0,0,0,0,0
0,0,0,1,0,0,1,1,0,0,0,1,0,0,0,0
0,0,0,0,1,0,0,0,1,1,0,0,1,0,0,0
0,0,0,0,0,1,0,0,1,1,1,0,0,1,0,0
0,0,0,0,0,0,1,0,0,1,1,1,0,0,1,0
0,0,0,0,0,0,0,1,0,0,1,1,0,0,0,1
0,0,0,0,0,0,0,0,1,0,0,0,1,1,0,0
0,0,0,0,0,0,0,0,0,1,0,0,1,1,1,0
0,0,0,0,0,0,0,0,0,0,1,0,0,1,1,1
0,0,0,0,0,0,0,0,0,0,0,1,0,0,1,1
